# Special countries..
REB = "countries/Rebels.txt"
PIR = "countries/Pirates.txt"
NAT = "countries/Natives.txt"

NRR = "countries/RumelianRepublic.txt"
LCT = "countries/LionsofCrescent.txt"
PRC = "countries/PeranConfederation.txt"
SOT = "countries/SonsofTengri.txt"
FTH = "countries/Fatih.txt"
ORT = "countries/Ortakoy.txt"
SIS = "countries/SisliClique.txt"
FNR = "countries/Fenerbahce.txt"
TCO = "countries/GeneralSecretary.txt"
ALB = "countries/Alibeykoy.txt"
HBP = "countries/Habipler.txt"
CBC = "countries/Cebeci.txt"
BYP = "countries/Bayrampasa.txt"
ESN = "countries/Esenler.txt"
DMK = "countries/Demirkapi.txt"
GON = "countries/NorthGOP.txt"
GOS = "countries/SouthGOP.txt"
USK = "countries/Uskudar.txt"
AKB = "countries/Akbayrakids.txt"
SUL = "countries/Suleymanids.txt"
ESP = "countries/Esatpasa.txt"
KZO = "countries/Kozyatagi.txt"
CMC = "countries/Camlica.txt"
KRT = "countries/Kartal.txt"
HLK = "countries/Halkali.txt"
ESY = "countries/Esenyurt.txt"
FRK = "countries/Firuzkoy.txt"
AKC = "countries/Akcaburgaz.txt"
AVC = "countries/Avcilar.txt"
BYK = "countries/Buyukcekmece.txt"
BGC = "countries/Bagcilar.txt"
GNG = "countries/Gungoren.txt"